20
8
00000000000000000000
02222222222222222220
02220000000022222220
0222222222-022222220
00000000000]00000j00
02222222222222222200
02222222222222222p00
00000000000000000000mNikol
50
5
120
120
50
4iNikol
4
4
4