20
8
00000000000000000000
0-2222m0222j22222220
02222220220022222220
02222222222022222220
00000000000000000220
]2222222222222222220
02222222222222p22220
00000000000000000000mAlex
20
10
50
50
30
1iAlex
1
1
1