34
8
##################################
#//////#//////////#///#//////////#
#//////#//#///////////#//////////#
#&/////////#//////////#//////////#
#################%#///#//######//#
#/////////////////#///#///////#//#
#$////////////////#///////////#//!
##################################mIvan
20
5
75
75
30iIvan
2
2
2