34
12
##################################
#//////#//////////#///#//////////#
#//////#//#////####///#//////////#
#&/////#//$#//////////#//////////#
######/##########%##//#//######//#
#//////#//////////##//#///////#//#
#//////#//#####///##//////////#//#
#//#####//#///////##//////////#//#
#//#//////#///######//////////#//#
#//#//#///#///######//////////#//#
#/////#///#///////////////////#//!
##################################mKolio
23
2
100
100
40iKolio
3
3
3