23
10
00000000000000000000000
022222202222222222p2220
02222220220222222222220
02222222222022222222220
00022200000000000j02220
02222222202222222022220
02222222202222222222200
02222222202222222222220
0m222222-02222222222220
0000000000]000000000000mStefo
50
2
230
230
50
9iStefo
9
9
9