20
10
00000000000000000000
022222222222222222p0
02222220000022222220
0222222222m0222222-0
00000000000000000j00
02222222222222222200
02222222222222222200
02222222222022222220
02222222222022222220
0000000000]000000000mNicky
50
2
210
210
50
8iNicky
8
8
8