20
10
####################
#//////#//////////$#
#//////#//#////////#
#//////////#///////#
#################%##
#/////////////////##
#////////////////&##
#//////////#///////#
#//////////#///////#
##########!#########mToni
50
2
200
200
50iToni
7
7
7