20
10
####################
#/////////////////$#
#//////#####///////#
#/////////&#///////#
#################%##
#/////////////////##
#/////////////////##
#//////////#///////#
#//////////#///////#
##########!#########mNicky
50
2
210
210
50iNicky
8
8
8