34
12
0000000000000000000000000000000000
0222222022222222220222022222222220
0222222022022220000222022222222220
0m22222022p02222222222022222222220
00000020000000000j0022022000000220
0222222022222222220022022222220220
0222222022000002220022222222220220
0220000022022222220022222222220220
0220222222022200000022222222220220
0220220222022200000022222222220220
0-2222022202222222222222222222022]
0000000000000000000000000000000000mKolio
23
2
100
100
40iKolio
3
3
3