34
8
##################################
#//////#/////////&#///#//////////#
#//////#//#///////////#//////////#
#//////////#//////////#//////////#
#################%#///#//######//#
#/////////////////#///#///////#//#
#/////////////////#///////////#/$#
#########!########################mPesho
60
7
150
150
60iPesho
5
5
5