34
8
0000000000000000000000000000000000
022222-022222222220222022222222220
0222222022022222222222022222222220
0m22222222202222222222022222222220
00000000000000000j0222022000000220
0222222222222222220222022222220220
0p2222222222222222022222222222022]
0000000000000000000000000000000000mIvan
20
5
75
75
30iIvan
2
2
2