20
10
00000000000000000000
022222202222222222m0
02222220220222222220
02222222222022222220
00000000000000000j00
02222222222222222200
02222222222222222p00
02222222222022222220
02222222222022222220
0000000000]000000000mToni
50
2
200
200
50iToni
7
7
7