23
10
#######################
#//////#//////////$///#
#//////#//#///////////#
#//////////#//////////#
###///###########%#///#
#////////#///////#////#
#////////#///////////##
#////////#////////////#
#&///////#////////////#
##########!############mStefo
50
2
230
230
50iStefo
9
9
9