20
8
####################
#//////////////////#
#///########///////#
#//////////#///////#
###########!#####%##
#/////////////////##
#////////////////$##
####################mNikol
50
5
120
120
50iNikol
4
4
4