20
8
####################
#/////&#///%///////#
#//////#//##///////#
#//////////#///////#
#################//#
!//////////////////#
#/////////////$#####
####################mAlex
20
10
50
50
30iAlex
1
1
1