34
12
##################################
#//////#//////////#///#/////////#
#//////#//#///////////#//////////#
#/////////&#//////////#//////////#
#################%#///#//######//#
#/////////////////#///#///////#//#
#/////////////////#///////////#//#
#/////////////////#///////////#//#
#///////$/////////#///////////#//#
#/////////////////#///////////#//#
#/////////////////#///////////#//!
##################################mIco
50
2
170
170
50iIco
6
6
6