34
12
0000000000000000000000000000000000
02222220222222222-0222022222222220
0222222022022222222222022222222220
0222222222m02222222222022222222220
00000000000000000j0222022000000220
0222222222222222220222022222220220
0222222222222222220222222222220220
0222222222222222220222222222220220
02222222p2222222220222222222220220
0222222222222222220222222222220220
022222222222222222022222222222022]
0000000000000000000000000000000000mIco
50
2
170
170
50iIco
6
6
6