34
8
0000000000000000000000000000000000
02222220222222222m0222022222222220
0222222022022222222222022222222220
0-22222222202222222222022222222220
00000000000000000j0222022000000220
0222222222222222220222022222220220
02222222222222222202222222222202p0
000000000]000000000000000000000000mPesho
60
7
150
150
60
5iPesho
5
5
5