23
10
#######################
#//////#/////////////#
#//////#//#///////////#
#//////////#//////////#
#////###############/%!
#/////////////////////#
#////////////////////##
#//////////#//////////#
#&/////////#/////////$#
#######################mNinjata
50
2
300
300
50iNinjata
10
10
10