23
10
00000000000000000000000
02222220222222222222220
02222220220222222222220
02222222222022222222220
022220000000000000002j]
02222222222222222222220
022222-2222222222222200
02222222222022222222220
0m2222222220222222222p0
00000000000000000000000mNinjata
50
2
300
300
50iNinjata
10
10
10